W,W,W,W,W,W,W,W,W,W,W,W,W,W,W,W,W,W,W,W,W,W,W,W,W,W,W,W,W,W,W,W,W,W,W,W,W,W,W,W,W,W,W,W,W,W,W,W,W,W,W,W,W,W,W
W, , , , , , , , , , , , , , , , , , , , , , , , , ,W, , , , , , , , , , , , , , , , , , , , , , , , , , , ,W 
W, , , , , , , , , , ,K-1, , , , ,K-2, , , , , , , , , ,W, , , , , , ,Z-B, , , , , , , , , , , , , , , , , , , , ,W
W, , , , , , , , , , , , , , , , , , , , , , , , , ,D-2, , , , , , , , , , , , , , , , ,B-A, , , , , , , , , , ,W 
W, , , , , , , , , , , , , , , , , , , , , , , , , ,W, , , , , , , , , , , , , , ,K-3, , , , , , , , , , , , ,W 
W, , , , , , , , , , , , , , , , , , , , , , , , , ,W, , , , , , , , , , , , , , , , , , , , , , , , , , , ,W 
W, ,S, , , , , , , , , , , , , , , , , , , , , , , ,W, , , , , , , , , , , , , , , , , , , , , , , , , , , ,W 
W, , , , , , , , , , , , , , , , , , , ,B-B, , , , , ,W, , , , , , , , , , , , , , , , , , , , , , , , , , , ,W 
W, , , , , , , , , , , , , , , , , , , , , , , , , ,W, , , , , , , , , , , , , , , , , , , , , , , , , , , ,W 
W, , , , , , , , , , , , , , , , , , , , , , , , , ,W, , , , , , ,W,W,D-3,W,W,W, , , , , , , , , , , , , , , ,W 
W, , , , , , , , , , , , , , , , , , , , , , , , , ,W, , , , , , ,W , ,B-C, , ,W, , , , , , , , , , , , , , , ,W
W, , , , , , , , , , , , , , , , , , , , , , , , , ,W, , , , , , ,W , , , , ,W, , , , , , , , , , , , , , , ,W 
W, , , , , , , , , , ,Z-A, , , , , , , , ,Z-C, , , , , ,W, , , , , , ,W , , , , ,W, , , , , , , , , , , , , , , ,W
W, , , , , , , , , , , , , , , , , , , , , , , , , ,D-1, , , , , , ,W , , , , ,W, , , , , , , , , , , , , , , ,W
W,W,W,W,W,W,W,W,W,W,W,W,W,W,W,W,W,W,W,W,W,W,W,W,W,W,W,W,W,W,W,W,W,W,W,W,W,W,W,W,W,W,W,W,W,W,W,W,W,W,W,W,W,W,W
